---P-----
-L-P--P--
RPPP--PPR
----R----
----P-H--
-H--P---V
----P----
-F--P---P
-R--F--F-
----H----
-----PPPV
--F--P---
--P--P-S-
-----P---